DEEEEEEEEEEEEEEEEEELEEEEEEEEEEEEEEEEEEG 
A  CCCCCCCCCCCCCC  A  CCCCCCCCCCCCCC  A 
A DEEEEEG DEEEEEEG A DEEEEEEG DEEEEEG A 
ACA     A A      ACACA      A A     ACA 
ACA     A A      ACACA      A A     ACA 
ACHEEEEEF HEEEEEEFCKCHEEEEEEF HEEEEEFCA 
ACCCCCCCCCCCCCCCCCCCCCCCCCCCCCCCCCCCCCA 
ACDEEEEEG DEEEG DEEEEEG DEEEG DEEEEEGCA 
ACHEEG  A HEEGA HEELEEF ADEEF A  DEEFCA 
AC   HEEFCCCCAA    A    AACCCCHEEF   CA 
A DG     CDGCAHEEG A DEEFACDGC     DG A 
A AJEEEEICHFCA   A A A   ACHFCNEEEEMA A 
A HF     CCCCHEEEF K HEEEFCCCC     HF A 
A    DEEG DG               DG DEEG    A 
HEEEEF  A HF DG NEI NEI DG HF A  HEEEEF 
        A    AA         AA    A         
        HEEG AA P     P AA DEEF         
           A AA         AA A            
           A HF NEI NEI HF A            
           ACCCCCCCCCCCCCCCA            
           A DG DEEEEEG DG A            
           A AA HEEEEEF AA A            
           A AA         AA A            
           A AA DEG DEG AA A            
DEEEEEEEEEEF HF HEF HEF HF HEEEEEEEEEEG 
A                                     A 
A DEEEEEGCDG DEEEEEEEEEEEG DGCDEEEEEG A 
A HEEEEGACAA HEEEEG DEEEEF AACADEEEEF A 
A      AACAA      A A      AACAA      A 
HEEEEG AACAA DEEG A A DEEG AACAA DEEEEF 
DEEEEF AACAA A  A A A A  A AACAA HEEEEG 
A      AACAA HEEF HEF HEEF AACAA      A 
ACDEEG AA HFCCCCCCCCCCCCCCCHFCAA DEEGCA 
ACA  A AA    DEEEEEEEEEEEG    AA A  ACA 
ACA  A HOEEI HEEEEG DEEEEF NEEOF A  ACA 
ACA  A            A A            A  ACA 
ACA  A DEEEEEEEEG A A DEEEEEEEEG A  ACA 
A HEEF HEEEEEEEEF HEF HEEEEEEEEF HEEF A 
A  CCCCCCCCCCCCCCCCCCCCCCCCCCCCCCCCC  A                
HEEEEEEEEEEEEEEEEEEEEEEEEEEEEEEEEEEEEEF 
                                        