DEEEEEEEEEEEEEEEEEELEEEEEEEEEEEEEEEEEEG 
A        CCC       A                  A 
A DEEEEEG DEEEEEEG A DEEEEEEG DEEEEEG A 
A A     A A      A A A      A A     A A 
A A     A A      A A A      A A     A A 
A HEEEEEF HEEEEEEF K HEEEEEEF HEEEEEF A 
A           CCCCC                 C   A 
A DEEEEEG DEEEG DEEEEEG DEEEG DEEEEEG A 
A HEEG  A HEEGA HEELEEF ADEEF A  DEEF A 
A    HEEF    AA    A    AA    HEEF    A 
A DG      DG AHEEG A DEEFA DG      DG A 
A AJEEEEI HF A   A A A   A HF NEEEEMA A 
A HF         HEEEF K HEEEF         HF A 
A    DEEG DG               DG DEEG    A 
HEEEEF  A HF DG NEI NEI DG HF A  HEEEEF 
        A    AA         AA    A         
        HEEG AA P     P AA DEEF         
           A AA         AA A            
           A HF NEI NEI HF A            
           A               A            
           A DG DEEEEEG DG A            
           A AA HEEEEEF AA A            
           A AA         AA A            
           A AA DEG DEG AA A            
DEEEEEEEEEEF HF HEF HEF HF HEEEEEEEEEEG 
A                                     A 
A DEEEEEG DG DEEEEEEEEEEEG DG DEEEEEG A 
A HEEEEGA AA HEEEEG DEEEEF AA ADEEEEF A 
A      AA AA      A A      AA AA      A 
HEEEEG AA AA DEEG A A DEEG AA AA DEEEEF 
DEEEEF AA AA A  A A A A  A AA AA HEEEEG 
A      AA AA HEEF HEF HEEF AA AA      A 
A DEEG AA HF               HF AA DEEG A 
A A  A AA    DEEEEEEEEEEEG    AA A  A A 
A A  A HOEEI HEEEEG DEEEEF NEEOF A  A A 
A A  A            A A            A  A A 
A A  A DEEEEEEEEG A A DEEEEEEEEG A  A A 
A HEEF HEEEEEEEEF HEF HEEEEEEEEF HEEF A 
A                                     A 
HEEEEEEEEEEEEEEEEEEEEEEEEEEEEEEEEEEEEEF 
                                        