BBBBBBBBBBBBBBBBBBBBBBBBBBBBBBBBBBBBBBBB
B        CCC       B                  BB
B BBBBBBB BBBBBBBB B BBBBBBBB BBBBBBB BB
B BBBBBBB BBBBBBBB B BBBBBBBB BBBBBBB BB
B BBBBBBB BBBBBBBB B BBBBBBBB BBBBBBB BB
B BBBBBBB BBBBBBBB B BBBBBBBB BBBBBBB BB
B           CCCCC                 C   BB
B BBBBBBB BBBBB BBBBBBB BBBBB BBBBBBB BB
B BBBBBBB BBBBB BBBBBBB BBBBB BBBBBBB BB
B    BBBB    BB    B    BB    BBBB    BB
B BB      BB BBBBB B BBBBB BB      BB BB
B BBBBBBB BB BBBBB B BBBBB BB BBBBBBB BB
B BB         BBBBB B BBBBB         BB BB
B    BBBB BB               BB BBBB    BB
BBBBBBBBB BB BB BBB BBB BB BB BBBBBBBBBB
BBBBBBBBB    BB         BB    BBBBBBBBBB
BBBBBBBBBBBB BB B     B BB BBBBBBBBBBBBB
BBBBBBBBBBBB BB         BB BBBBBBBBBBBBB
BBBBBBBBBBBB BB BBB BBB BB BBBBBBBBBBBBB
BBBBBBBBBBBB               BBBBBBBBBBBBB
BBBBBBBBBBBB BB BBBBBBB BB BBBBBBBBBBBBB
BBBBBBBBBBBB BB BBBBBBB BB BBBBBBBBBBBBB
BBBBBBBBBBBB BB         BB BBBBBBBBBBBBB
BBBBBBBBBBBB BB BBB BBB BB BBBBBBBBBBBBB
BBBBBBBBBBBB BB BBB BBB BB BBBBBBBBBBBBB
B                                     BB
B BBBBBBB BB BBBBBBBBBBBBB BB BBBBBBB BB
B BBBBBBB BB BBBBBBBBBBBBB BB BBBBBBB BB
B      BB BB      BBB      BB BB      BB
BBBBBB BB BB BBBB BBB BBBB BB BB BBBBBBB
BBBBBB BB BB BBBB BBB BBBB BB BB BBBBBBB
B      BB BB BBBB BBB BBBB BB BB      BB
B BBBB BB BB               BB BB BBBB BB
B BBBB BB    BBBBBBBBBBBBB    BB BBBB BB
BPBBBB BBBBB BBBBBBBBBBBBB BBBBB BBBBPBB
B BBBB            BBB            BBBB BB
B BBBB BBBBBBBBBB BBB BBBBBBBBBB BBBB BB
B BBBB BBBBBBBBBB BBB BBBBBBBBBB BBBB BB
B                                     BB
BBBBBBBBBBBBBBBBBBBBBBBBBBBBBBBBBBBBBBBB
BBBBBBBBBBBBBBBBBBBBBBBBBBBBBBBBBBBBBBBB